11111111
101000x1
10101001
10111011
10000001
10010111
10100001
11111111
