11111111
100000x1
10000001
10000001
10000001
10000001
10000001
11111111
